- - - - - - - -
- - - # # - - -
- - # # # # - -
- # # # # # # -
- # # # # # # -
- - # # # # - -
- - - # # - - -
- - - - - - - -
