- - - - - - - -
- # # # # # # -
- - - # # - - -
- # # - - # # -
- # # - - # # -
- - - # # - - -
- # # # # # # -
- - - - - - - -
