# # # - - # # #
# # # # # # # #
# - - # # - - #
- # # - - # # -
- # # - - # # -
# - - # # - - #
# # # # # # # #
# # # - - # # #
